11111111
1P0000P1
10000E01
1C0000E1
11111111