111111111
200000001
1000P0012
200C00C02
100E00001
111111111