111111111
100E00001
100000000
1C0000000
10P000000
111111110