111111111
1000VP001
1000000E1
100000C01
111111111