111111
1E0P00
10C000
1111111111