111111111111111111
100000000000001111
1000000E0000000111
111111111111111111
100000000000000001
100000000000000001
1C0000000000C00001
1P0000000000000001
111111111111111111