111111111111111111
100000000000001111
1000000E0000000111
111111111111111111
100000000000000001
111000000000000011
1C1000000000C000C1
1P0000000000000101
111111111111111111