1111111111111111111111111111111
1000000000000000000000000000001
11111111111C000000000C000000001
1000000000000000000E00000000001
1000000000000000000000000000001
1000000000000000000000000000001
1000000000000000000C00000000001
100000000000000000P111111111111
1111111111111111111111111111111