11111111111111111111111
10000000000000000000001
11111111111C000000000C1
1000000000000000000E001
10000000000000000000001
10000000000000000000001
1000000000000000000C001
100000000000000000P1111
11111111111111111111111