11111111
11000001
1P000001
1C0E0001
10000001
11111111
