1111111111111111
1000CE1000000001
1C01000000000001
1000000000000001
1000000000000001
1000000000000001
10000C000C0000C1
1000C000C000C001
1000000000000001
1P00000000000001
1111111111111111