1111
1C01
1P01
1E11
1001
1001
1001
1001
1111