1111111111111111
1000CE1000000001
1C00000000000001
1000001111111111
1000000000000001
1111111110000001
10000C000C0000C1
1000C000C000C001
1111111111111101
1000000P00CCC001
1111111111111111