11111111111111111111111
10000000000000000000001
10000000000C000000000C1
1000C00000000000000E001
1000C000000000000000001
1000C000000000000000001
1000C000000000000000001
1000P000000000000000001
11111111111111111111111