1111111
1P00CE1
1C01111
1111111